#.##############################
#.#####..#########...###########
#....###.####....###.#....######
####.###......##.###.####.######
###..#...####.##.###..###.##.###
###.#########.##...##.###.##.###
###.####....#.####...........###
###.####.##.#.####.######.######
###......##...##...######.######
################.###.........###
#......###.##..#.###.######.####
#.####.###.##.##.###.##.###.####
#.##.....................#######
#.##############.##########...##
#.##############.###........####
#.#######........#####.#########
#.#######.############.#########
#....####.######.###........####
######....##.........#.####.####
##.....#######.#######.####...##
##.###.........##.####.#########
##.##############.####.##..#####
##......###...###.####.###.#####
###########.#####.####.###.#####
###....................##..#####
#######.######.#######.##.######
##......######.#######....######
#######.######.##......#########
#######........##.####.#########
#################.####......####
######################.#########
################################