#.#############################
#.#####..#########...##########
#....###.####....###.#....#####
####.###......##.###.####.#####
###..#...####.##.###..###.##.##
###.#########.##...##.###.##.##
###.####....#.####...........##
###.####.##.#.####.######.#####
###......##...##...######.#####
################.###.........##
#......###.##..#.###.######.###
#.####.###.##.##.###.##.###.###
#.##.....................######
#.##############.##########...#
#.##############.###........###
#.#######........#####.########
#.#######.############.########
#....####.######.###........###
######....##.........#.####.###
##.....#######.#######.####...#
##.###.........##.####.########
##.##############.####.##..####
##......###...###.####.###.####
###########.#####.####.###.####
###....................##..####
#######.######.#######.##.#####
##......######.#######....#####
#######.######.##......########
#######........##.####.########
#################.####......###
######################.########
###############################